1
おとな - adult
ついたち - first day of the month
みっつ - three things
かざん - volcano
かく - to write, to draw
としより - old people, the aged
やすむ - to take a day off
なんぜん - many thousands
いきいき - vividly, lively
ひとつ - one thing
おおげさ - exaggerated
おやすみなさい - good night
とおか - ten days
よっつ - four things
ここのつ - nine things  
なのか - seven days
おかあさん - mother
としごろ - approximate age
にほん - japan
おおきい - big
ことし - this year
いまごろ - about this time
ちゅうがく - middle school
ほんにん - the person himself

2
おんなのこ - girl
まいしゅう - every week
ひとり - one person, alone
だいがくせい - university student
みっか - three days
ごぜん - morning, a.m.
がいこく - foreign country
ここのか - nine days
ようか - eight days
がくねん - year in school
たいして - not so much, not very
よっか - four days
せんげつ - last month
ふるい - old (not person)
おおみず - flood
きょう - today
ともだち - friend, companion
こんしゅう - this week
こんにちは - hello, good day
あがる - to rise, to ascend
どの - which, what way
せんじつ - the other day
おまえ - you (inferior, subordinate)
なまえ - name

3
だんし - youth, young man
おとうさん - father
まいつき - every month
ほんの - mere, only, just
にゅうこく - entry to a country
だいがく - university, college
しょうがくせい - elementary school student
いきる - to live, to exist
おりる - to descend, to disembark
きゅうじつ - holiday, day off
ちゅうねん - middle age
ななつ - seven things
くださる - to give, to confer
はいる - to enter, to join
いれる - to put in, bring in, insert
おばさん - old lady
まいにち - every day
じんせい - human life
はつか - twenty days
めいじん - master, expert
がくせい - student
ほんごく - one's own country
なんとなく - somehow or other
くだらない - good for nothing, stupid
やすみ - rest, vacation

4
むっつ - six things
かわかみ - upriver, upstream
としした - younger, junior
おとこらしい - manly
やっつ - eight things
なにか - something
ふぼ - parents
こくがい - outside the country
せんせい - teacher, master, doctor
むいか - six days
にゅうがく - entry to school or university
いつつ - five things
ひとごみ - crowd of people
ごがつ - may
ふたつ - two things
じょし - woman, girl
ひざし - sunlight, rays of the sun
ちいさい - small
まなぶ - to study (in depth), to learn
したがき - rough copy, draft, draught
ほんみょう - real name
おとこのこ - boy
ひのいり - sunset
うまれ - birth, birthplace
こくめい - country name

5
いっしょう - whole life, a lifetime
せんしゅう - last week
がいこくじん - foreigner
ひなか - daytime, during the day
おとなしい - obedient, docile, quiet
のぼる - to climb, to ascend
ふつか - two days
さげる - to lower
ちゅうがくせい - junior high school student
おんならしい - ladylike, feminine
みかづき - new moon, crescent moon
まいとし - every year
いりぐち - entrance
としうえ - older, senior
いつか - five days
こども - child, children
